#levelNumber=1
#levelTime=20
0 0 0 0 0 0 0 0 0 0 0 0
0 0 0 0 0 3 3 3 0 0 0 0
0 0 0 0 0 3 2 3 0 0 0 0
0 0 0 0 0 3 1 3 3 3 3 0
0 0 0 3 3 3 4 1 4 2 3 0
0 0 0 3 2 1 4 5 3 3 3 0
0 0 0 3 3 3 3 4 3 0 0 0
0 0 0 0 0 0 3 2 3 0 0 0
0 0 0 0 0 0 3 3 3 0 0 0
0 0 0 0 0 0 0 0 0 0 0 0