#levelNumber=6
#levelTime=250
0 0 0 0 0 0 0 0 0 0 0 0
0 0 3 3 3 3 3 3 3 0 0 0
0 0 3 3 1 2 1 5 3 0 0 0
0 0 3 1 4 1 4 1 3 0 0 0
0 0 3 2 1 6 1 2 3 0 0 0
0 0 3 1 4 1 4 1 3 0 0 0
0 0 3 3 1 2 1 3 3 0 0 0
0 0 3 3 3 3 3 3 3 0 0 0
0 0 0 0 0 0 0 0 0 0 0 0
0 0 0 0 0 0 0 0 0 0 0 0