#levelNumber=8
#levelTime=250
0 0 0 0 0 0 0 0 0 0 0 0
0 0 0 0 0 0 0 0 0 0 0 0
0 0 0 0 3 3 3 3 3 3 0 0
0 0 0 0 3 1 1 1 1 3 0 0
0 0 3 3 3 4 4 4 1 3 0 0
0 0 3 5 1 4 2 2 1 3 0 0
0 0 3 1 4 2 2 2 3 3 0 0
0 0 3 3 3 3 1 1 3 0 0 0
0 0 0 0 0 3 3 3 3 0 0 0
0 0 0 0 0 0 0 0 0 0 0 0