#levelNumber=9
#levelTime=300
0 0 0 0 0 0 0 0 0 0 0 0
0 0 0 0 0 0 0 0 0 0 0 0
0 0 3 3 3 3 3 3 3 0 0 0
0 0 3 2 1 2 1 2 3 0 0 0
0 0 3 1 4 4 4 1 3 0 0 0
0 0 3 2 4 5 4 2 3 0 0 0
0 0 3 1 4 4 4 1 3 0 0 0
0 0 3 2 1 2 1 2 3 0 0 0
0 0 3 3 3 3 3 3 3 0 0 0
0 0 0 0 0 0 0 0 0 0 0 0