#levelNumber=10
#levelTime=300
0 0 0 0 0 0 0 0 0 0 0 0
0 0 0 0 0 0 0 0 0 0 0 0
0 0 3 3 3 3 3 3 3 0 0 0
0 0 3 1 1 2 1 5 3 0 0 0
0 3 3 4 4 2 4 4 3 3 0 0
0 3 1 2 2 6 2 2 1 3 0 0
0 3 1 4 4 2 4 4 1 3 0 0
0 3 1 1 1 2 1 1 1 3 0 0
0 3 3 3 3 3 3 3 3 3 0 0
0 0 0 0 0 0 0 0 0 0 0 0