#levelNumber=2
#levelTime=60
0 0 0 0 0 0 0 0 0 0 0 0
0 0 0 0 0 0 0 0 0 0 0 0
0 0 3 3 3 3 3 3 3 0 0 0
0 0 3 2 1 4 1 2 3 0 0 0
0 0 3 1 4 5 4 1 3 0 0 0
0 0 3 2 1 4 1 2 3 0 0 0
0 0 3 3 3 3 3 3 3 0 0 0
0 0 0 0 0 0 0 0 0 0 0 0
0 0 0 0 0 0 0 0 0 0 0 0
0 0 0 0 0 0 0 0 0 0 0 0